###############
##         #  #
#  #### ##### #
# ### #     # #
#     ##### # #
## # +#   # # #
## #### ### # #
#  #    #   # #
# ## #### ### #
# #     #     #
# # ### #### ##
#   #   #     #
##### ### ### #
#     #   #   #
#######-#######