###############
##         #* #
#  #### ##### #
# ### #     # #
#     ##### # #
## # +#  |# # #
## #### ### # #
#  #    #   # #
# ## #### ### #
# #     #     #
# # ### #### ##
#   #   #     #
##### ### ### #
#/    #   #   #
#######-#######